################
#..............#
#..............#
#..............#
#..............#
#.........##...#
#.........##...#
#..............#
#..............#
#..............#
#..............#
#..............#
#..............#
#..............#
#..............#
################